1	W AH N
100	W AH N HH AH N D R AH D
11	IH L EH V AH N
11th	IH L EH V AH N TH
12	T W EH L V
13th	TH ER T IY N TH
15th	F IH F T IY N TH
18th	EY T IY N TH
2	T UW
20	T W EH N T IY
200	T UW HH AH N D R AH D
21	T W EH N T IY W AO N
24	T W EH N T IY F AO R
2nd	S EH K AH N D
3	TH R IY
30	TH ER D IY
4	F OW R
4th	F AO R TH
5AM	F AY V EY EH M
6	S IH K S
60	S IH K S T IY
63	S IH K S T IY TH R IY
70	S EH V AH N T IY
72nd	S EH V AH N T IY S EH K AH N D
75	S EH V AH N T IY F AY V
9	N AY N
ABUIN	AH B UW N
AGEING	EY JH IH NG
AJDABIYA	AE JH D AH B IY AY AH
ALEP	AE L AH P
ALIGHTING	AH L AY T IH NG
ALZHEIMERS	AE L Z HH IY M AH R Z
AWOKEN	AH W OW K AH N
BAIRN	B AE AH R N
BAIRN'S	B AE AH R N Z
BAW	B AO
BEDDIE	B EH D IY
BEGGAR'S	B EH G ER Z
BINGS	B IY IH NG Z
BOARDWALKING	B OW R D W AO K IH NG
BOMBIN	B AA M IH N
BONFIRE'S	B AA N F AY ER Z
BOSSOM	B AA S AH M
BOTHY	B AA TH IY
BRAITH	B R EY TH
BRENNIN	B R EH N AH N
BUGLER	B Y UW G AH L ER
BULBUL	B UH L B AH L
BURDS	B AH R D Z
BURN'S	B ER N Z
BYGAUN	B IH G AH N
CAFÈ	K AE F
CAILLEACH	K EY L IY CH
CAMELLIA	K AH M IY L Y AH
CAMPOUT	K AE M P AW T
CANDLELIT	K AE N D AH L IH T
CAUNLES	K AO N AH L Z
CEMETARY	S EH M AH T EH R IY
CHAUMER	CH AO M AH R
CHEERIES	CH IH ER IY Z
CHILDHOOD'S	CH AY L D HH UH D Z
CHRYSANTHAMUMS	K R AH S AE N TH AH M AH M Z
CHUNTERING	CH AH N T IY R AH NG
CITYSCAPE	S IH T IY S K EY P
CLACKING	K L AE K AH NG
CLEANER'S	K L IY N ER Z
CLOTHESLINE	K L OW DH Z L AY N
CONFORMATION	K AA N F AO R M EY SH AH N
COORT	K OW AO R T
COORTIN	K OW AO R T AH N
CORN'S	K AO R N Z
COTTONFIELDS	K AA T AH N F IY L D Z
CRESCENT'S	K R EH S AH N TS
CROTON	K R AA T AH N
DAMSELFLIES	D AE M Z AH L F L AY Z
DARKENS	D AA R K AH N Z
DAWIN	D AO AH N
DEID	D IY IH D
DEWED	D IY W EH D
DOON	D UW AO N
DRAGONFLIES	D R AE G AH N F L AY Z
DRAGONFLY	D R AE G AH N F L AY
DRAGONFLY'S	D R AE G AH N F L AY Z
DRIPPINGS	D R IH P IH NG Z
DUDOON	D Y UW D UW N
DUMPIN'S	D AH M P IH N Z
DUNT	D AH N T
DUSKY	D AH S K IY
EDDYING	EH D IY IH NG
EEIN	IY AH N
EFTER	EH F T AH R
EGRETS	IY G R AH T S
EID'S	AY D Z
ENLIGHTMENT	EH N L AY T M AH N T
FAIMILY	F EY M AH L IY
FAITHER'S	F EY TH ER Z
FAMILAR	F EY M AH L AH R
FIRELIGHT	F AY ER L AY T
FIREPIT	F AY ER P IH T
FIREWORK'S	F AY R W ER K S
FLAVOURED	F L AH V OW Y AH R D
FOEHN	F OW AH N
FOGGED	F AA G D
FOONERAL	F UW N AH R AH L
FOOTBRIDGE	F UH T B R IH JH
FOU	F UW
FRAE	F R IY
FREESTY	F R IY S T IY
FUFFS	F AH F S
FUSHIN	F AH SH AH N
GARDEVINE	G AA R D AH V AY N
GEMINIDS	JH EH M IH N AH D Z
GIBBOUS	JH IH B AH S
GINKO	JH IH NG K OW
GLEANERS	G L IY N ER Z
GOGH'S	G OW Z
GRAITH	G R EY TH
GRANFAITHER	G R AE N F EY DH AH R
GRANITA	G R AE N AH T AH
GREYNESS	G R EY N AH S
GUID	G UW D
GURGLES	G ER G AH L Z
HABEMUS	HH AE B AH M AH S
HAILSTANES	HH EY L S T EY N Z
HAME	HH EY M
HAMELESS	HH EY M L AH S
HAWK'S	HH AO K S
HEDGEROW	HH EH JH R OW
HIBISCUS	HH AH B IH S AH S
HOGMANAY	HH AA G M AA N AH IY
HORIZONLESS	HH AH R AY Z AH N L AH S
HUESO'S	HH Y UW AH S AH Z
HUNKERS	HH AH NG K ER Z
HURKLE	HH AH R K AH L
ICEBLEAK	AY S B L IY K
IDES	AY D Z
JALOUSIES	JH AE L AW S AY Z
JOURNEY'S	JH ER N IY Z
KIPPLE	K IH P AH L
KIRKSTONE	K AH R K S T OW N
KNACKIN	N AE K IH N
KOI	K OY
KUMQUATS	K AH M K W EY T S
LANTERNLESS	L AE N T ER N L AH S
LARACH	L AE R AH CH
LENGHTENING	L EH N T IY N AH NG
LENTEN	L EH N T AH N
LEPRONE	L EH P R OW N
LIGGIN	L IH JH AH N
LILYS	L IH L IY Z
LOWPIN	L OW P IH N
LUMS	L AH M Z
MAISIC	M EY Z IH K
MAITIN	M EY T AH N
MAWS	M AO Z
MAYFLOWERS	M EY F L AW ER Z
MCDO	M K D OW
MEDITATIN	M AH D IH T AH T AH N
MERKIT	M AH R K AH T
METEORITES	M IY T IY AH R AY T S
MEZCAL	M EH Z K AH L
MILLENIUM	M IH L IY N IY AH M
MISO	M AH S OW
MISTFALL	M IH S T F AO L
MIZZLE	M IH Z AH L
MOONLESS	M UW N L AH S
MOONLESSNESS	M UW N L AH S N AH S
MOONRISE	M UW N R AY Z
MOONSET	M UW N S EH T
MOWN	M OW N
MUEZZIN'S	M Y UW EH Z AH N Z
MUIN	M UW N
MURMURINGS	M ER M ER IH NG Z
MURTHER	M AH R DH AH R
NAPE	N EY P
NEBBIN	N EH B AH N
NECKLINE	N EH K L AY N
NICHT	N IH CH T
NIPPIE	N IH P IY
NOONDAY	N UW N D EY
NOVOCAIN	N AA V AH K EY N
OFFSHORING	AO F SH OW R IH NG
ONDING	AA N D AH NG
OOTBY	UW T B IY
ORTHOPAEDIC	AO R TH AH P IY D AH K
ORTHOPEDIST'S	AO R TH AH P IY D AH S TS
OWER	OW ER
OWL'S	AW L Z
PAINTBOX	P EY N T B AA K S
PAPAM	P AE P AH M
PARAUD	P AE R AH D
PARETE	P AH R IY T
PATHLESS	P AE TH L AH S
PAWPRINTS	P AO P R IH N T S
PERSEID	P AH R S AY D
PERSEIDS	P AH R S AY D Z
PERSIMMON	P ER S IH M AH N
PHEASIE	F IY S AY
PIGTAILED	P IH G T EY L D
PINECONES	P AY N K OW N Z
POMEGRANATES	P AH M EH G R AH N EY T S
POPLARS	P AA P L ER Z
POWLONIA	P OW L OW N Y AH
PRANAYAMA	P R AH N EY AH M AH
PUDDLED	P AH D AH L D
PUIL	P UW L
QUAT	K W AA T
RAINBURST	R EY N B ER S T
RAINFORST	R EY N F AH R S T
RAXIN	R AE K S AH N
REMEMBERANCE	R IH M EH M B ER AH N S
REOCCURRENCE	R IY AH K ER AH N S
RIN	R IH N
RIVULETS	R IH V Y AH L AH T S
ROADKILL	R OW D K IH L
ROON	R UW N
ROSEBUDS	R OW Z B AH D Z
ROSHI	R AA SH IY
SAMHAIN	S AE M HH EY N
SATIE	S AE T IY
SAWINS	S AO IH N Z
SCENTING	S EH N T IH NG
SCRIBBLINGS	S K R IH B AH L IH NG Z
SCUDDING	S K AH D IH NG
SEABREEZE	S IY B R IY Z
SEARCHER'S	S ER CH ER Z
SENIOR'S	S IY N Y ER Z
SESSHIN	S EH S AH N
SHOOGLIN	SH UW G L AH N
SHRILLING	SH R IH L IH NG
SILBURY	S IH L B Y AH R IY
SINGUL	S IH N G AH L
SIZZLES	S IH Z AH L Z
SKYS	S K AY Z
SLEETY	S L IY T IY
SMUDGES	S M AH JH IH Z
SNAGGIT	S N AE JH AH T
SNOWMELT	S N OW M EH L T
SNOWPACK	S N OW P AE K
SOUCH	S AW CH
SOURDOUGH	S AW ER D OW
SOUTHEND	S AW TH EH N D
SPLATTING	S P L AE T AH NG
STARLESS	S T AA R L AH S
STEEPING	S T IY P IH NG
STREETLIGHT	S T R IY T L AY T
STUBBLED	S T AH B AH L D
SUDDENT	S AH D AH N T
SULLA	S AH L AH
SULPHURIC	S AH L F ER IH K
SUNLESS	S AH N L AH S
TAILGATING	T EY L G EY T IH NG
TARN	T AA R N
TEAHOUSE	T IY HH AW S
TENTIE	T EH N T IY
TERRASSENG‰RTEN	T EH R AE S EH N G R T AH N
THAYR	TH EY R
THIGGER	TH IH G AH R
THROUCH	TH R AW CH
THUNDERHEADS	TH AH N D ER HH EH D Z
TONIGHTS	T AH N AY T S
TRAFIC	T R AE F AH K
TRAINYARD	T R EY N Y AA R D
TRINITARIAN	T R IH N AH T EH R IY AH N
TROKE	T R OW K
TROOT	T R UW T
TUIM	T UW M
TWENTYFOURSEVEN	T W EH N T IY F OW R S EH V AH N
TYPOS	T IH P AH Z
UNAIMED	AH N EY M D
UNCOS	AH N K AA Z
UNDRESSING	AH N D R EH S IH NG
UNDULATION	AH N JH AH L EY SH AH N
UNHOOKING	AH N HH UH K IH NG
UNKNOTTING	AH N AA T IH NG
UNMOWN	AH N M OW N
UNPICKED	AH N P IH K T
UNRIPE	AH N R AY P
UNTRODDEN	AH N T R AA D AH N
UNTWISTING	AH N T W IH S T IH NG
VERANDAH	V AH R AE N D AH
VISAKHA	V AH S AE K AH
VOAR	V OW AH R
WASHDAY	W AA SH D EY
WEEDOWER	W IY D AW ER
WEET	W IY T
WI	W IY
WIDESCREEN	W AY D S K R IY N
WIFIE	W AY F IY
WINDLESS	W IH N D L AH S
WINNOCK	W IH N AH K
WINTERSCAPE	W IH N T ER S K EY P
WISTERIA	W IH S T IY R IY AH
WOODFIRE	W UH D F AY ER
WOODSMOKE	W UH D S M OW K
XMAS	Z M AE Z
YELLOWED	Y EH L OW D
ZAZEN	Z EY Z AH N
AAH	AA
ABANDONNED	AH B AE N D AH N D
ADVENTS	AE D V EH N T S
AFF	AE F
AIK	EY K
ALANG	AE L AH NG
ALEPPO	AH L EH P OW
ALJAZEERA	AE L JH EY Z AH R AH
ALORS	EY L ER Z
AMANG	AE M AH NG
AMISSIN	AH M IH S IH N
ANEATH	EY N IY TH
ANITHER	AE N AH DH AH R
APPARTMENT	AE P AA R T M AH N T
APRËS	AE P R Z
ASIATIQUE	EY S IY AH T AH K
ASPIRINE	AE S AH R AY N
ATHORT	AE TH AH R T
ATTENDRE	AE T EH N D AH R
ATTERCAP'S	AE T AH R K AH P S
ATWEEN	AE T W IY AH N
AULDER	AO L D AH R
AUSSI	AO S IY
AUTRE	AO T AH R
AWAKES	AH W EY K S
BACKROAD	B AE K R OW D
BAIRNS	B AE AH R N Z
BALCONY'S	B AE L K AH N IY Z
BARBERSHOPS	B AA R B ER SH AA P S
BARMAID	B AA R M EY D
BARRISTA	B AE R IH S T AH
BATTEMENT	B AE T M AH N T
BAUNK	B AO NG K
BEETLE'S	B IY T AH L Z
BIDES	B AY D Z
BIGBANGS	B IH G B AE NG Z
BIGGIN	B IH G JH IH N
BIN'S	B IH N Z
BIRCHES	B ER CH IH Z
BIRDBATH	B ER D B AE TH
BIRTHDATE	B ER TH D EY T
BISECTED	B AY S EH K T IH D
BITTERNUT	B IH T ER N AH T
BLACKBIRD'S	B L AE K B ER D Z
BLACKTHORN	B L AE K TH AO R N
BLAE	B L IY
BLEATING	B L IY T IH NG
BLECKIE	B L EH K AY
BLINTER	B L IH N T AH R
BLUEBIRD'S	B L UW B ER D Z
BODACH	B AA D AH CH
BOGGY	B AO G IY
BOMBSQUAD	B AA M S K W AA D
BRAYING	B R EY IH NG
BREASTCANCER	B R EH S T K AE N S ER
BREERS	B R IH R Z
BROOZILT	B R UW Z AH L T
BRUME	B R UW M
BRUSTIN	B R AH S T AH N
BUDDAH'S	B AH D AH Z
BUDDHAS	B AH D HH AH Z
BUDDLEIA	B AH D L IY AH
BULBUL'S	B UH L B Y AH L Z
BUMMERS	B AH M ER Z
BUOY'S	B UW IY Z
BUS'S	B AH S IX Z
BUTTERIES	B AH T AH R IY Z
CACHER	K AE SH ER
CALMÈ	K AA M
CAMELLIAS	K AH M IY L Y AH Z
CAMION	K AE M IY AH N
CANDLE'S	K AE N D AH L Z
CARAPACE	K AA R AH P EY S
CARBUNCLES	K AA R B AH NG K AH L Z
CARP'S	K AA R P S
CASHPOINT	K AE SH P OY N T
CENOTAPH	S EH N AH T AH F
CEO'S	S IY IY OW Z
CEREUS	S IH R IY AH S
CHALEUR	CH EY L AH R
CHALKBOARD	CH AO K B OW R D
CHANGEFUL	CH EY N JH F AH L
CHEEN	CH IY AH N
CHERR	CH EH R
CHEVEUX	CH IY V IY AH K S
CHICKADEE	CH IH K EY D IY
CHICKADEES	CH IH K EY D IY Z
CHICKPEA	CH IH K P IY
CHIEL	CH IY L
CHIENS	CH IY N Z
CHOPIN'S	SH OW P AE N Z
CHUCHOTANT	CH AH CH AH T AH N T
CLAUCHT	K L AO CH T
CLINTS	K L IH N T S
CLOUD'S	K L AW D Z
COCKERELS	K AA K EH R AH L Z
COCKSCOMB	K AA K S K OW M
COFFEECUP	K AO F IY K AH P
COFFINMAKER	K AO F AH N M EY K ER
COMBINERS	K AH M B AY N ER Z
COMPTANT	K AA M P T AH N T
CONTRAIL	K AH N T R EY L
CONTRAILS	K AH N T R EY L Z
COPPERTONE	K AA P ER T OW N
CORDITE	K AA R D AY T
COUK	K OW AH K
CRADLESONG	K R EY D AH L S AO NG
CRAWS	K R AO Z
CRAYONED	K R EY AA N D
CREAKS	K R IY K S
CRISIUM	K R IH S IY AH M
CROTTLES	K R AA T AH L Z
CRUCIFORM	K R UW S AH F AH R M
CRUIVED	K R UW W AH V D
CYPRESSES	S AY P R AH S IH Z
D'APRËS	D AE P R Z
D'UN	D AH N
DAFFINS	D AE F AH N Z
DAFFODILLS	D AE F AH D AH L Z
DAHLIAS	D AE L IY AH Z
DAITH	D EY TH
DAMSELFLY	D AE M Z AH L F L AY
DAMSONS	D AE M S AH N Z
DAPPLES	D AE P AH L Z
DEEIN	D IY IY N
DEFLATES	D IH F L EY T S
DEGRÈS	D EH G R Z
DEWDROPS	D UW D R AA P S
DIMANCHE	D IH M AH NG K
DIMP	D IH M P
DISPERSES	D IH S P ER S IH Z
DISSONATE	D IH S AH N AH T
DISUSED	D IH S Y UW S T
DOIVENT	D OW IH V AH N T
DONKEY'S	D AA NG K IY Z
DOUCENESS	D UW S N AH S
DOVE'S	D AH V Z
DOVERIN	D AH V ER IH N
DRAPT	D R AE P T
DUGS	D AH G Z
DUSK'S	D AH S K S
DUSTPAN	D AH S T P AE N
DUVET	D Y UW V AH T
DÈCOLLETAGE	D K AA L AH T AH JH
DÈCOLLETÈ	D K AA L AH T
EARING	IH ER IH NG
EENIN'S	IY N AH N Z
EFFACED	IH F EY S T
EGRET'S	EH G R AH TS
ELK'S	EH L K S
EMBAUMÈ	IH M B AO M
EMOJI	AH M AA JH IY
ENFIN	EH N F IH N
ERASBLE	EH R AH Z AH L
EX'S	EH K S IX Z
EXTUINGUISHED	IH K S T UW N G W AH SH T
FAIMLIE	F EY M L AY
FARENHEIT	F AE R AH N HH IY T
FARTS	F AA R T S
FAWIN	F AO AH N
FEUILLES	F Y UW AH L Z
FISHNET	F IH SH N EH T
FLAILS	F L EY L Z
FLASHMOB	F L AE SH M AA B
FLUFFING	F L AH F IH NG
FLURIES	F L UW R IY Z
FLUTIST'S	F L UW T IH S TS
FOGGING	F AA G IH NG
FOGHORNS	F AA G HH AO R N Z
FORFOCHEN	F AO R F AH CH AH N
FORRIT	F AO R AH T
FOUIN'S	F AW AH N Z
FREENLY	F R IY N L IY
FREESIA'S	F R IY S IY AH Z
FREESIAS	F R IY S IY AH Z
FRIDGIDAIRE	F R IH JH IH D AH AH R
FRISB	F R IH Z
FUITPRENT	F UW T R AH N T
FULNESS	F UH L N AH S
FUSH	F AH SH
FUSHER	F AH SH AH R
FUSKY	F AH S IY
FUSPERS	F AH S AH R Z
GAITHERIN	G EY TH ER IH N
GEEZERS	JH IY Z AH R Z
GENTIANS	JH EH N CH AH N Z
GERFALCON'S	JH AH R F AE L K AH N Z
GLAUR	G L AO R
GLISTENS	G L IH S AH N Z
GLOWWORM	G L OW W ER M
GNOME'S	N OW M Z
GOLDENRODS	G OW L D AH N R AA D Z
GORSE	G AO R S
GRAMOPHONE	G R AE M AH F OW N
GRANBAIRN	G R AE N B AH AH R N
GRANDCHILD'S	G R AE N D CH AY L D Z
GREENGROCER	G R IY N G R OW S ER
GRIS	G R IH Z
GROOM'S	G R UW M Z
GUNPORT	G AH N P OW R T
HAIGA	HH EY G AH
HAIJIN	HH EY JH AH N
HAIJIN'S	HH EY JH AH N Z
HALAL	HH EY L AH L
HARNS	HH AA R N Z
HASHTAGS	HH AE SH T AE G Z
HATCHLINGS	HH AE CH L IH NG Z
HAUDS	HH AO D Z
HAUFLIN	HH AO F L AH N
HD	EY CH D
HEALINGS	HH IY L IH NG Z
HEELD	HH IY L D
HEICH	HH IY CH
HEIZES	HH IY AY Z AH Z
HEREYES	HH IY R EY Z
HEROINS	HH EH R AH W AH N Z
HERRCUTS	HH EH R K Y UW T S
HIJAB	HH IH JH AH B
HOARFROSTED	HH OW ER F R AO S T IH D
HOMEBREW	HH OW M B R UW
HOUSEWIFE'S	HH AW S W AY F S
HUNGERT	HH AH N JH AH R T
HUNGERT'S	HH AH N JH AH R T S
ICIER	AY S IY ER
ICYCLES	IH S AH K AH L Z
INCAA	IH N K AA
INCHWORM	IH N CH W ER M
INDECISIONS	IH N D IH S IH ZH AH N Z
INFUSÈ	IH N F AH S
INTERUPTED	IH N T ER AH P T EH D
IORA	AY AH R AH
IRIDESCE	IH R AH D EH S
IRIDISCENT	AY ER AH D IY Z S EH N T
ITHER	IH DH AH R
J'AJUSTE	JH AE JH AH S T
JACARANDA	JH AE K AH R AE N D AH
JOGGER'S	JH AA G ER Z
JYLE	JH AY L
KEEKIN	K IY K AH N
KINFOLK	K IH N F OW K
KITE'S	K AY TS
KNEELS	N IY L Z
KNIFE'S	N AY F S
KOAN	K OW AH N
L'ASPHALTE	L AE S AH L T
L'IMAGE	L IH M AH JH
L'OMBRA	L AA M B R AH
L'ÈCHOGRAPHIE	L CH AA G R AH F AY
LAMPLIGHT	L AE M P L AY T
LAMPSHADE	L AE M P SH EY D
LAQUELLE	L AE K W AH L
LARMES	L AA R M Z
LAUP	L AO P
LEAF'S	L IY F S
LETTERBOX	L EH T ER B AA K S
LEURS	L IY Y AH R Z
LICHENED	L AH CH IY N D
LICHTENIN	L IH CH T AH N AH N
LIGHTNING'S	L AY T N IH NG Z
LIGUSTRUM	L AH G AH S T R AH M
LIK	L IH K
LILLIES	L IH L AY Z
LIMACE	L IH M AH S
LOODER	L UW D AH R
LOON'S	L UW N Z
LOVESONG	L AH V S AO NG
LOZEN	L OW Z AH N
LUVE	L UW V
LUVERS	L UW V AH R Z
MAGICIAN'S	M AH JH IH SH AH N Z
MAGPIE'S	M AE G P AY Z
MAHJONG	M AE JH AH NG
MAILMAN'S	M EY L M AE N Z
MAIRCHS	M AE AH R CH S
MAITIT	M EY T AH T
MANGROVES	M AE N G R OW V Z
MANTELPIECE	M AE N T AH L P IY S
MAPLE'S	M EY P AH L Z
MARIAGE	M EH R IY IH JH
MATIN	M AE T AH N
MAÓTRES	M EY T AH R Z
MEDS	M IY D Z
MELANCHOLIA	M EH L AH NG K OW L Y AH
MEMORIAL'S	M AH M AO R IY AH L Z
MEMORIAM	M AH M AO R IY AH M
METRONOME	M EH T R AH N OW M
MICROSOFTIES	M AY K R OW S AO F T IY Z
MIDNIGHT'S	M IH D N AY TS
MIGRANT'S	M AY G R AH N TS
MIGRATORS	M AY G R AH T ER Z
MINTY	M IH N T IY
MISTED	M IH S T EH D
MOOTHIE	M UW TH IY
MOSQUITO'S	M AH S K IY T OW Z
MOTH'S	M AO TH S
MOUTEN	M OW Y UW T AH N
MUIN'S	M UW N Z
MUINLICHT	M UW N L AH CH T
MUIVE	M Y UW AH V
MUSIQUE	M Y UW S AH K
MYNAH	M IH N AH
MYNDIN	M IH N D AH N
NAE	N IY
NAPPY	N AE P IY
NASTURTIUM	N AE S T AH R T IY AH M
NEIST	N IY AH S T
NETTOYE	N EH T OY
NIGHTGOWN	N AY T G AW N
NIGHTLIGHT	N AY T L AY T
NOCTURNE	N AA K T ER N
NUDISTS	N UW D IH S T S
OCTOBRE	AA K T AH B AH R
ODEUR	OW D AH R
OMMMMM	AA M
ON'R	AA N R
ON'S	AA N Z
OOR	OW AH R
OOT	UW T
OOTLINE	UW T L AY N
PACIFC	P AE S AH F
PALMYRA	P AE L M AH R AH
PANGAEA	P AE N G IY AH
PARLENT	P AA R L EH N T
PARMI	P AA R M IY
PATTERING	P AE T ER IH NG
PAULM	P AO L M
PAVÈ	P AE V
PEARLED	P ER L D
PEERIE	P IH ER IY
PEKOE	P EH K OW
PERFIT	P ER F IH T
PHOTY	F OW T IY
PHOTYS	F AA T AH Z
PIERCES	P IH ER S IH Z
PIKELETS	P AY K L AH T S
PIKIT	P IH K AH T
PINE'S	P AY N Z
PIPISTRELLE'S	P IH P AH S T R EH L AH Z
PISH	P IH SH
PISLE	P AY Z AH L
PLAINSTANES	P L EY N S T EY N Z
PLOOM	P L UW M
PLUIE	P L UW
PLUMERIA	P L UW M IY R IY AH
POLISHES	P AA L IH SH IH Z
PONY'S	P OW N IY Z
POSSOM	P AA S AH M
PREENS	P R IY N Z
PRENDRE	P R IY N D AH R
PUB'S	P AH B Z
PULPMILL	P AH L P M IH L
PUMKINS	P AH M K AH N Z
PUMPKIN'S	P AH M P K IH N Z
PURSING	P ER S IH NG
PYNED	P AY N D
QUEENSBOROUGH	K W IY N Z B ER OW
QUINIE	K W IH N AY
RAIN'S	R EY N Z
RAINLESS	R EY N L AH S
RAIRS	R AE AH R Z
RANTS	R AE N T S
RAVEN'S	R EY V AH N Z
REARRANGES	R IY AH R EY N JH IH Z
RECEPTIONIST'S	R IH S EH P SH AH N IH S TS
RECESSIONALS	R IY S EH SH AH N AH L Z
RECUMBENT	R IH K AH M B AH N T
REDWING'S	R EH D W IH NG Z
REEK'S	R IY K S
REEKIN	R IY K IH N
REELIN	R IY L IH N
REENG	R IY EH NG
REENG'M	R IY EH N G M
REGARDANT	R IH G AA R D AH N T
RELIGHTING	R IY L AY T IH NG
REREADS	R IY R IY D Z
RESETTING	R IY S EH T IH NG
RESOUNDS	R IY S AW N D Z
REVISTS	R EH V IH S T S
RHODODENDRONS	R OW D AH D EH N D R AH N Z
RICOCHETS	R IH K AH SH EY Z
RINGTONES	R IH NG T OW N Z
ROADKILL'S	R OW D K IH L Z
ROOFTILES	R UW F T AY L Z
ROOND	R UW N D
ROSÈ	R AA Z
ROUGING	R UW ZH IH NG
ROUSES	R AW Z IH Z
RUINAGE	R UW AH N IH JH
RUSTLES	R AH S AH L Z
RYOKAN	R AY AH K AH N
SAIJIKI	S EY JH AH K IY
SANDPIPER	S AE N D P AY P ER
SAREE	S AH R IY IY
SAWN	S AO N
SCATTERS	S K AE T ER Z
SCHUIL	S K UW L
SCLIMIN	S K L IH M AH N
SCREENSAVER	S K R IY N S EY V ER
SCRIEVIT	S K R IY V AH T
SCRIPS	S K R IH P S
SCRUBS	S K R AH B Z
SCRUIF	S K R UW F
SCURRIES	S K ER IY Z
SCYCLE	S IH K AH L
SEAPLANE	S IY P L EY N
SEEIN	S IY IH N
SEGUES	S EH G Z
SENDAI	S EH N D EY
SES	S
SFUMATO	S F Y UW M AH T OW
SHALLOWS	SH AE L OW Z
SHEDDAE	SH EH D IY
SHEDDAED	SH EH D EY D
SHEDDAES	SH EH D EY Z
SHEEPDOG	SH IY P D AO G
SHEPERDS	SH EH P AH R D Z
SHIKI	SH IH K IY
SHINNING	SH IH N IH NG
SHOREBIRD'S	SH AO R B ER D Z
SHOUTHERS	SH AW TH AH R Z
SICHT'S	S IH CH T S
SILLAGE	S IH L IH JH
SIN'S	S IH N Z
SKATEBOARDS	S K EY T B OW R D Z
SKIER'S	S K AY R Z
SKIRLIN	S K AH R L AH N
SKIRLS	S K AH R L Z
SKITES	S K AY T S
SKYLARK'S	S K AY L AA R K S
SLAMMIN	S L AE M AH N
SMOULDERING	S M OW L D IY R AH NG
SNAW	S N AO
SNAWDRAPS	S N AO D R AH P S
SNIFFENT	S N IH F AH N T
SNOWDRIFT	S N OW D R IH F T
SNOWDROPS	S N OW D R AA P S
SNOWK	S N OW K
SNOWMEN	S N OW M EH N
SNUVES	S N Y UW V Z
SOLDERS	S AA D ER Z
SOLENT	S OW L AH N T
SOOKIN	S UH K AH N
SOOND	S UW N D
SOUNDLESS	S AW N D L AH S
SPANIEL'S	S P AE N Y AH L Z
SPARROW'S	S P EH R OW Z
SPIDER'S	S P AY D ER Z
SPIDERWEB	S P AY D ER W EH B
SPINNAKERS	S P IH N AH K AH R Z
SPINNED	S P IH N D
SPLIFF	S P L IH F
SPLUTTERS	S P L AH T AH R Z
SQUEEGEES	S K W IY JH IY Z
SQUERRS'S	S K W EH R Z AH Z
STALLION'S	S T AE L Y AH N Z
STAME	S T EY M
STARLING'S	S T AA R L IH NG Z
STATUE'S	S T AE CH UW Z
STERNY	S T ER N IY
STILLAMONG	S T IH L AH M AH NG
STOBBIE	S T AA B AY
STREEKIT	S T R IY K AH T
STREENG'N	S T R IY N G N
STREETLAMPS	S T R IY T L AE M P S
STREETLIGHTS	S T R IY T L AY T S
STRIPLIGHTS	S T R IH P L AY T S
STRISCIA	S T R IH SH IY AH
SUBPRIME	S AH B P R AY M
SUMYIN'S	S AH M IY IH N Z
SUNBATHES	S AH N B EY DH Z
SUNDOGS	S AH N D AO G Z
SUNRAY	S AH N R EY
SWALE	S W EY L
SWALLOW'S	S W AA L OW Z
SWAN'S	S W AA N Z
SWANSONGS	S W AA N S AO NG Z
SWATS	S W AA T S
SYCAMORES	S IH K AH M AH R Z
SYNE	S AY N
TACHOGRAPH	T AH CH AA G R AH F
TAEN	T EY AH N
TAK'M	T AE K M
TAKKIN	T AE K AH N
TAMARIND	T AE M AH R AY N D
TANNINS	T AE N AH N Z
TASSIE	T AE S AY
TATOO	T AE T UW
TEABAG	T IY B AE G
TEAKETTLE	T IY K EH T AH L
TEDDIES	T EH D IY Z
TEEGER	T IY JH AH R
TEINTES	T IY N T S
THAIM	TH EY M
THAIR	TH AE AH R
THINGUMS	TH IH N G AH M Z
THRABS	TH R AE B Z
THRANG	TH R AE NG
THRAWINS	TH R AO AH N Z
THRISSELS	TH R IH S AH L Z
THUDS	TH AH D Z
THUNDERCLAPS	TH AH N D ER K L AE P S
THUNDERCLOUDS	TH AH N D ER K L AW D Z
THUNDERHEAD	TH AH N D ER HH EH D
THÈ	T IY EY CH
TILL'S	T IH L Z
TIRLIES	T AH R L AY Z
TOHOKU	T AA HH AH K UW
TOKYOITES	T AA K AY OY T S
TOMBENT	T UW M AH N T
TONNERRE	T AA N AH R
TRACERY	T R EY S AH R IY
TRACKLESS	T R AE K L AH S
TRAMWAYS	T R AE M W EY Z
TRAVAILLANT	T R AH V EY L AH N T
TREE'S	T R IY Z
TREEHOUSE	T R IY HH AW S
TRILLS	T R IH L Z
TUIN	T UW N
TUITH	T UW TH
TWA	T W AA
TWINES	T W AY N Z
UDDER	AH D AH R
ULTRAMARINE	AH L T R AH M AH R IY N
UNBLINKING	AH N B L IH NG K IH NG
UNCARVED	AH N K AA R V D
UNCELEBRATED	AH N S EH L AH B R EY T IH D
UNCLIMBED	AH N K L AY M D
UNCOMBED	AH N K AH M B EH D
UNDERTHINGS	AH N D ER TH IH NG Z
UNDRUNK	AH N D R AH NG K
UNE	AH N
UNEATEN	AH N IY T AH N
UNFASHIONABLY	AH N F AE SH AH N AH B L IY
UNKNOT	AH N AA T
UNRETURNED	AH N R IY T ER N D
UNSCRATCHED	AH N S K R AE CH T
UNSHAVED	AH N SH EY V D
UNTIES	AH N T AY Z
UNTUNED	AH N T UW N D
UPTURNT	AH P T AH R N T
VACUM	V AE K AH M
VAIS	V EY AH S
VENNELS	V EH N AH L Z
VERDIGRIS	V AH R D IH G R AH S
VERRAZANO	V EH R AE Z AH N OW
VESPERS	V EH S AH R Z
VET'S	V EH TS
VIEILLES	V IY AH L Z
VIII	V IY IY
VOLENT	V OW L AH N T
VOLO	V OW L OW
VOMITS	V AA M AH T S
VOYAGEURS	V W AA Y AA ZH ER Z
WAB	W AA B
WABSTER	W AA B S T AH R
WADDIN	W AA D IH N
WADDLING	W AA D L AH NG
WAE	W IY
WAFTS	W AA F T S
WAGTAILS	W AE G T EY L Z
WAIRMTH	W AE AH R M TH
WAKENED	W EY K AH N D
WATCHTOWER	W AA CH T AW ER
WATERFALL'S	W AO T ER F AO L Z
WATERPIPE	W AO T ER P AY P
WATTER	W AA T ER
WATTERGAW	W AA T AH R G AH
WATTERSIDE	W AA T ER S AY D
WAUKEN	W AO K AH N
WAVELETS	W EY V L AH T S
WAVERS	W EY V ER Z
WAXWINGS	W AE K S W IH NG Z
WEATHERWORN	W EH DH ER W OW R N
WHEEL'S	W IY L Z
WHIISKY	W IY S IY
WHITEBOARD	W AY T B OW R D
WHITEOUT	W AY T AW T
WHITEOUTS	W AY T AW T S
WINDOW'S	W IH N D OW Z
WINDSCREEN	W IH N D S K R IY N
WISPS	W IH S P S
WOO'N	W UW N
WOODPECKER'S	W UH D P EH K ER Z
WOODSTOVE	W UH D S T OW V
WOODYARDS	W UH D Y AA R D Z
WULLFLOOERS	W AH L F L UW AH R Z
WUND	W AH N D
WUNNERS	W AH N AH R Z
YALLA	Y AE L AH
YILL	Y IH L
YINCE	Y IH N S
YIRDIN	Y AH R D AH N
YIRTH	Y AH R TH
YOUTHIE	Y UW TH IY
YOWLIN	Y OW L AH N
ABSENTLY	AE B S AH N T L IY
ADZE	AE D Z
AGAVE	AH G EY V
AHHS	AE HH S
ALDERS	AE L D AH R Z
ALIGHTS	AH L AY T S
ALLELUIAS	AE L EH L UW AH Z
ALLHALLOWS	AO L HH AE L OW Z
ALYSSUM	EY L IY Z S AH M
AND'SCRATCHES	AE N D Z S K R AE CH IH Z
ANEMONES	AE N AH M OW N Z
ANGLER'S	AE NG G L ER Z
ANNOUNCER'S	AH N AW N S ER Z
ANT'S	AE N TS
ANTHURIUM	AE N TH UH R IY AH M
ANYOLDHOW	AE N AY OW L D HH OW
APPLEMINT	AE P AH L M IH N T
APPLEWOOD	AE P AH L W UH D
APRONED	EY P R AH N D
AQUAJOGGING	AE K W AH JH AA G IH NG
ARMFUL	AA R M F UH L
ARMLOAD	AA R M L OW D
ARPEGGIOS	AA R P EH JH IY OW Z
ASO	AE S OW
ASTIR	AH S T ER
AWAKING	AH W EY K IH NG
BAAING	B AA AH NG
BAG'S	B AE G Z
BALED	B EY L D
BALLERINA'S	B AE L ER IY N AH Z
BARBWIRE	B AA R B W AY ER
BARECHESTED	B EH R CH EH S T IH D
BARENESS	B EH R N AH S
BARN'S	B AA R N Z
BARNACLED	B AA R N AH K AH L D
BARNWOOD	B AA R N W UH D
BARTENDER'S	B AA R T EH N D ER Z
BARWARE	B AA R W EH R
BASSWOOD	B EY S W UH D
BAT'S	B AE TS
BATTERY'S	B AE T ER IY Z
BAYBERRY	B EY B EH R IY
BEACHCOMBING	B IY CH K OW M IH NG
BEACHGOERS	B IY CH G OW ER Z
BEACHSTORE	B IY CH S T OW R
BEANSTALKS	B IY N S T AO K S
BEAVER'S	B IY V ER Z
BEEHIVES	B IY HH AY V Z
BEEKEEPER'S	B IY K IY P ER Z
BEERCAN	B IH ER K AE N
BELLRINGER'S	B EH L R IH NG ER Z
BHND	B IY EY CH EH N D
BILLABONG	B IH L AH B AA NG
BINDWEED	B AY N D W IY D
BIRCHBARK	B ER CH B AA R K
BIRDLAND	B ER D L AE N D
BITTERN	B AY T AH R N
BITTERN'S	B AY T AH R N Z
BLACKSMITH'S	B L AE K S M IH TH S
BLANCHED	B L AE N CH T
BLINKERS	B L IH NG K ER Z
BLOODWORK	B L AH D W ER K
BLOWFLY	B L OW F L AY
BLOWFLY'S	B L OW F L AY Z
BLOWSY	B L OW Z IY
BLUEGILLS	B L UW G IH L Z
BLUEJAYS	B L UW JH EY Z
BLUESTEM	B L UW S T EH M
BLUETIT	B L UW T IH T
BOATMAN'S	B OW T M AH N Z
BOATSHED	B OW T SH EH D
BOATSIDE	B OW T S AY D
BOBS	B AA B Z
BOBWHITES	B AA B W AY T S
BODYBUILDER	B AA D IY B IH L D ER
BOOTPRINTS	B UW T P R IH N T S
BOTTLEBRUSH	B AA T AH L B R AH SH
BOUGAINVILLEAS	B AW G EY N V IH L IY Z
BOUTONNI	B AW T AA N IY
BOWERBIRD	B AW ER B ER D
BREADMAKER	B R EH D M EY K ER
BRIARS	B R AY ER Z
BRISTLECONE	B R IH S AH L K OW N
BRITTLENESS	B R IH T AH L N AH S
BROADNESS	B R AO D N AH S
BROGUE	B R AA G
BROMELIAD	B R AH M IY L IY AH D
BROMELIADS	B R AH M IY L IY AH D Z
BROOMSAGE	B R UW M S EY JH
BRUSHSTROKES	B R AH SH S T R OW K S
BUBBLEGUM	B AH B AH L G AH M
BUCKET'S	B AH K IH TS
BUFFALOES	B AH F AH L OW Z
BULLFROG'S	B UH L F R AO G Z
BULLRUSHES	B UH L R AH SH IH Z
BULRUSHES	B UH L R AH SH AH Z
BUMBLED	B AH M B AH L D
BURRS	B ER Z
BUTTEFLY	B Y UW T F L AY
BUTTERBUR	B AH T AH R B AH R
BUTTONING	B AH T AH N IH NG
CADDIS	K AE D IY Z
CAF	K AE F
CALLIGRAPHER'S	K AH L IH G R AH F ER Z
CAMPHOR	K AE M F AH R
CANAP'S	K AE N AH P S
CANOE'S	K AH N UW Z
CANTED	K AE N T IH D
CAPERING	K EY P ER IH NG
CARNIES	K AA R N IY Z
CAROLERS	K AE R AH L ER Z
CAROLING	K AE R AH L IH NG
CARPARK	K AA R P AA R K
CARPOOLING	K AA R P UW L IH NG
CARTOGRAPHER	K AA R T AA G R AH F AH R
CATTAIL	K AE T EY L
CATTAILS	K AE T EY L Z
CAVEMEN	K EY V M EH N
CAWING	K AO IH NG
CAWS	K AO Z
CELLAR'S	S EH L ER Z
CENTERLINE	S EH N T ER L AY N
CHACHALACAS	CH AH CH AE L AH K AH Z
CHAINSAWED	CH EY N S AO D
CHALLAH	CH AE L AH
CHANTERELLES	CH AE N T AH R AH L Z
CHERRYWOOD	CH EH R IY W UH D
CHIGGER	CH IH G ER
CHIMPUNK	CH IH M P AH NG K
CHINOOK'S	SH IH N UH K S
CHINS	CH IH N Z
CHIPMUNK'S	CH IH P M AH NG K S
CHIRRUP	CH AH R AH P
CICADA'S	S AH K EY D AH Z
CLACKETY	K L AE K AH T IY
CLAPPERLESS	K L AE P ER L AH S
CLATTERS	K L AE T ER Z
CLEAROUT	K L IH ER AW T
CLEARWING'S	K L IH ER W IH NG Z
CLIFFSIDE	K L IH F S AY D
CLINKING	K L IH NG K IH NG
CLINKS	K L IH NG K S
CLOD	K L AA D
CLODS	K L AA D Z
CLONKING	K L AO NG K AH NG
CLOSSSE	K L AA S
CLOTHESLINES	K L OW DH Z L AY N Z
CLOTHESPIN	K L OW DH S P IH N
CLOUDCAST	K L AW D K AE S T
CLOWN'S	K L AW N Z
CLYDESDALES	K L IH D AH Z D EY L Z
COCK'S	K AA K S
COCKCROW	K AA K R OW
COCKEREL	K AA K EH R AH L
COCKLEBURS	K AA K L EH B Y AH R Z
COFFEEPOT	K AO F IY P AA T
COLADA	K OW L AE D AH
COLORIST'S	K AH L ER IH S T S
COLOURFUL	K AH L ER F AH L
COMBINE'S	K AA M B AY N Z
CONDENSES	K AH N D EH N S IH Z
CONJOINT	K AH N JH OY N T
CONTINUO	K AH N T IH N Y AH W OW
CONTRAINDICATIONS	K AA N T R AH IH N D AH K EY SH AH N Z
CORDGRASS	K AO R D G R AE S
CORELLAS	K OW R AH L AE Z
CORKSCREWS	K AO R K S K R UW Z
CORMORANT'S	K AO R M ER AH N TS
CORNFLAKES	K AO R N F L EY K S
CORNSILK	K AO R N S IH L K
COTTONTAIL	K AA T AH N T EY L
COULDN	K OW AH L D N
COWLED	K AW L D
COWPAT	K AW P AE T
COWRIE	K OW R AY
COWSHED	K AW SH EH D
COXSWAIN'S	K AA Z S W EY N Z
COYOTE'S	K AY OW T IY Z
CRABAPPLE	K R AE B AE P AH L
CRABAPPLES	K R AE B AE P AH L Z
CRADLED	K R EY D AH L D
CRAWDAD'S	K R AO D AH D Z
CRAWLERS	K R AO L ER Z
CREASED	K R IY S T
CREATURE'S	K R IY CH ER Z
CREEKBED	K R IY K B EH D
CREEKSIDE	K R IY K S AY D
CREWELWORK	K R UW AH L W ER K
CRICKETING	K R IH K AH T IH NG
CROAKS	K R OW K S
CROSSWINDS	K R AO S W IH N D Z
CROUCHES	K R AW CH IH Z
CUBICAL	K Y UW B IH K AH L
CUD	K AH D
CUMMERBUND	K AH M AH R B AH N D
CUMULONIMBUS	K Y UW M Y UW L AH N IH M B AH S
CUMULUS	K Y UW M Y AH L AH S
CUPPED	K AH P T
CURLEW	K AH R L UW
CURLEWS	K AH R L UW Z
CURRANT	K ER AH N T
CURVACEOUS	K ER V EY SH AH S
CUTTER'S	K AH T ER Z
CUTTLEBONE	K AH T L AH B OW N
DAGUERREOTYPE	D AE G W EH R IY AH T AY P
DAMSELFLY'S	D AE M Z AH L F L AY Z
DAPPLED	D AE P AH L D
DARKNESSES	D AA R K N AH S IH Z
DAYLILIES	D EY L IY L IY Z
DAYMOON	D EY M UW N
DAZZLES	D AE Z AH L Z
DEADFALL	D EH D F AO L
DECOY'S	D AH K OY Z
DECRYSTALIZING	D IY K R IH S T AH L AY Z IH NG
DEER'S	D IH R Z
DERELICT'S	D EH R AH L IH K TS
DEWDROP	D UW D R AA P
DEWPOINT	D UW P OY N T
DIANTHUS	D AY AE N TH AH S
DICES	D AY S IH Z
DIDN	D IH D N
DINGHIES	D IH NG IY Z
DIPPER'S	D IH P ER Z
DISASSEMBLES	D IH S AH S EH M B AH L Z
DISENTANGLES	D IH S EH N T AE NG G AH L Z
DISHCLOTH	D IH SH K L AO TH
DISHRAG	D IH SH R AE G
DISHWATER	D IH SH W AO T ER
DISTENDS	D IH S T EH N D Z
DOESN	D OW AH Z N
DOGDAY	D AO G D EY
DOJO	D OW JH OW
DOORYARD	D OW R Y AA R D
DOPPELG	D AA P AH L G
DOVEFEEDING	D AH V F IY D IH NG
DOVETAILING	D AH V T EY L IH NG
DOWNLAND	D AW N L AE N D
DOWNSHIFTS	D AW N SH IH F T S
DOWSER'S	D AW Z ER Z
DOZY	D OW Z IY
DRAKE'S	D R EY K S
DRAUGHTY	D R AE F T IY
DREAMCATCHER'S	D R IY M K AE CH ER Z
DRIZZLES	D R IH Z AH L Z
DRUNKARD'S	D R AH NG K ER D Z
DUMPSTER'S	D AH M P S T ER Z
DUNKING	D AH NG K IH NG
DUNNOCK'S	D AH N AH K S
DUOMO	D Y UW AH M OW
DUSTINGS	D AH S T IH NG Z
EARWIG	IH ER W IH G
EASTERTIDE	IY S T ER T AY D
EDAMAME	EH D AH M EY M
EIDERDOWN	IY D AH R D OW N
EIDERS	IY D AH R Z
ELDER'S	EH L D ER Z
EMOTICONS	IH M OW T IH K AO N Z
EMU'S	IY M Y UW Z
EPHEMERIS	AH F EH M AH R AH S
ERHU	EH R UW
EUCALYPT	Y UW K AH L AH P T
EVENSONG	IY V AH N S AO NG
EVENTIDE	IY V AH N T AY D
EVERGREEN'S	EH V ER G R IY N Z
EWE'S	Y UW Z
EXHALES	EH K S HH EY L Z
FADO	F AE D OW
FAULTLINE	F AO L T L AY N
FAWN'S	F AO N Z
FAWNS	F AO N Z
FENCELINE	F EH N S L AY N
FENCEPOST	F EH N S P OW S T
FENCEPOSTS	F EH N S P OW S T S
FERMAT'S	F AH R M EY T S
FETLOCKS	F EH T L AH K S
FICUS	F AY K AH S
FIDDLEHEAD	F IH D AH L HH EH D
FIDDLEHEADS	F IH D AH L HH EH D Z
FILIGREED	F AH L IH G R IY D
FINCH'S	F IH N CH IX Z
FINGERLINGS	F IH NG G ER L IH NG Z
FIREBOX	F AY ER B AA K S
FIREFLY'S	F AY ER F L AY Z
FIRETHORN	F AY ER TH AO R N
FISHERMEN'S	F IH SH ER M IH N Z
FLATBED'S	F L AE T B EH D Z
FLATTENS	F L AE T AH N Z
FLEDGLINGS	F L EH JH L IH NG Z
FLICKED	F L IH K T
FLICKER'S	F L IH K ER Z
FLINCHES	F L IH N CH IH Z
FLITS	F L IH T S
FLOATPLANE	F L OW T P L EY N
FLOCK'S	F L AA K S
FLOES	F L OW Z
FLOODLIT	F L AH D L IH T
FLOWER'S	F L AW ER Z
FLOWERLESS	F L AW ER L AH S
FLOWERPOTS	F L AW ER P AA T S
FLOXGLOVES	F L AA K S G L OW V Z
FLUTE'S	F L UW TS
FLYCATCHER'S	F L AY K AE CH ER Z
FLYTHESE	F L AH TH IY Z
FOGHORN	F AA G HH AO R N
FOOTSTOOL	F UH T S T UW L
FORDING	F OW R D IH NG
FORGETFULNESS	F AO R G EH T F AH L N AH S
FORSYTHIA'S	F AO R S IH TH IY AH Z
FORT'S	F AO R TS
FOSSICKS	F AA S AH K S
FOUNTAIN'S	F AW N T AH N Z
FRANCIS'S	F R AE N S AH S IX Z
FRANGIPANI	F R AE N JH AH P AE N IY
FRECKLING	F R EH K AH L IH NG
FRESHETS	F R EH SH AH T S
FRINGED	F R IH N JH D
FRITILLARIES	F R AH T IH L AH R AY Z
FRUITBOWL	F R UW T B OW L
FRUITFLIES	F R UW T F L AY Z
FUCHSIA	F Y UW SH AH
FULLTHROATED	F UH L TH R OW T IH D
FUNERAL'S	F Y UW N ER AH L Z
FUNNIES	F AH N IY Z
FURLED	F ER L D
FURROWS	F ER OW Z
GALAHS	G AE L AH Z
GANNET	G AE N AH T
GANNETS	G AE N AH T S
GARTERSNAKE	G AA R T ER S N EY K
GATEPOST	G EY T P OW S T
GATOR'S	G EY T ER Z
GAZILLION	G AH Z IH L IY AH N
GECKO'S	G EH K OW Z
GESSO	JH EH S OW
GHOSTING	G OW S T IH NG
GINKGO	G IH NG K OW
GINKGO'S	G IH NG K OW Z
GIRDLED	G ER D AH L D
GLADIOLA	G L EY D IY AH L AH
GLASSBLOWER'S	G L AE S B L OW ER Z
GLIDER'S	G L AY D ER Z
GLINTS	G L IH N T S
GLISSANDO	G L IH S AE N D OW
GLISSANDOS	G L IH S AE N D AH Z
GLORY'S	G L AO R IY Z
GNAT'S	N AE TS
GODWITS	G AA D W IH T S
GOOSEFLESH	G UW S F L EH SH
GORGED	G AO R JH D
GOSLINGS	G OW S L IH NG Z
GRADER'S	G R EY D ER Z
GRAINFIELD	G R EY N F IY L D
GRASSHOPPER'S	G R AE S HH AA P ER Z
GRAVEDIGGER	G R EY V D IH G ER
GRAVID	G R AE V AH D
GRAZES	G R EY Z IH Z
GREBES	G R IY B Z
GRINDSTONE'S	G R AY N D S T OW N Z
GRITTED	G R IH T IH D
GROSBEAK'S	G R OW S B IY K S
GRUBBLE	G R AH B AH L
GUMBOOTS	G AH M B UW T S
GUMTREES	G AH M T R IY Z
HACKY	HH AE K IY
HAIRBALL	HH EH R B AO L
HAIRDRESSER'S	HH EH R D R EH S ER Z
HAIRGRASS	HH EH R G R AE S
HALLOW'S	HH AE L OW Z
HALLOWE	HH AO L OW
HALOED	HH EY L OW D
HALOES	HH EY L OW Z
HAMBONE	HH AE M B OW N
HAMMOCK'S	HH AE M AH K S
HANDBLOWN	HH AE N D B L OW N
HANDPRINT	HH AE N D P R IH N T
HANDPRINTS	HH AE N D P R IH N T S
HAPHAZARDS	HH AE P HH AE Z ER D Z
HARDHAT	HH AA R D HH AE T
HARLEYS	HH AA R L EY Z
HARP'S	HH AA R P S
HARPIST'S	HH AA R P IH S TS
HATCHLING	HH AE CH L IH NG
HAYROLL	HH EY R OW L
HAYSHED	HH EY SH EH D
HEADLAMPS	HH EH D L AE M P S
HEADLAND	HH EH D L AE N D
HEADLANDS	HH EH D L AE N D Z
HEALER'S	HH IY L ER Z
HEARSE'S	HH ER S IX Z
HEARTSICK	HH AA R T S IH K
HEATHCLIFFS	HH IY TH L AH F S
HEATWAVE	HH IY T W EY V
HEATWAVES	HH IY T W EY V Z
HEAVENWARD	HH EH V AH N W ER D
HEMLOCKS	HH EH M L AA K S
HEPATICA	HH AH P AE T AH K AH
HERETO	HH EH R AH T OW
HIGGINSON'S	HH IH G IH N S AH N Z
HISAJO	HH IH S AH JH OW
HISSS	HH IH S
HOARDER'S	HH OW R D AH R Z
HOARFROST	HH OW ER F R AO S T
HOBOS	HH OW B OW Z
HOD	HH AA D
HOKUSAI'S	HH AA K Y AH S EY Z
HONEYBEE'S	HH AH N IY B IY Z
HOODIES	HH UH D IY Z
HOOTING	HH UW T IH NG
HORSEAPPLES	HH AO R S AE P AH L Z
HOTOTOGISU	HH AA T AH T AA JH AH S UW
HOUND'S	HH AW N D Z
HOUSEFLIES	HH AW S F L AY Z
HOUSEFLY'S	HH AW S F L AY Z
HUCKLEBERRIES	HH AH K L AH B EH R AY Z
HUMMERS	HH AH M ER Z
HUMMINGBIRD'S	HH AH M IH NG B ER D Z
HURLS	HH ER L Z
HUSHES	HH AH SH IH Z
HUSKING	HH AH S K IH NG
HYDRANGEA	HH IH D R AE N JH IY AH
HYDRANGEAS	HH IH D R AE N JH IY Z
ICESNOW	AY S N OW
IKEBANA	AH K EH B AH N AH
INCHWORM'S	IH N CH W ER M Z
INDENTATIONS	IH N D EH N T EY SH AH N Z
INHALES	IH N HH EY L Z
INKSTONE	IH NG K S T OW N
INSTRUCTOR'S	IH N S T R AH K T ER Z
INTERCONNECTEDNESS	IH N T ER K AH N EH K T AH D N AH S
INWARDS	IH N W ER D Z
IRIDESCENCE	IH R AH D EH S AH N S
ISOBAR	IH S AH B AH R
IV	IH V
IVORIES	AY V AH R IY Z
JACKKNIFE	JH AE K N AY F
JACKSNIPES	JH AE K S N AY P S
JAMBALYA	JH AE M B AE L AY AH
JAMUN	JH AE M AH N
JAR'S	JH AA R Z
JAZZBAND	JH AE Z B AE N D
JELLYBEANS	JH EH L IY B IY N Z
JETTY'S	JH EH T IY Z
JIMSON	JH IH M S AH N
JOCKEY'S	JH AA K IY Z
JONQUILS	JH AA N K W AH L Z
JUNCOS	JH AH NG K AH Z
JUNIPER'S	JH UW N AH P ER Z
KADDISH	K AA D IH SH
KAHLO	K AE L OW
KANGAROO'S	K AE NG G ER UW Z
KATYDID'S	K EY T IY D IH D Z
KATYDIDS	K AE T AH D AH D Z
KEENING	K IY N IH NG
KESTREL	K EH S T R AH L
KETTLE'S	K EH T AH L Z
KICKIN	K IH K IH N
KIGO	K IH G OW
KILLDEER	K IH L D IH ER
KINDERGARTENERS	K IH N D ER G AA R T AH N ER Z
KINDLES	K IH N D AH L Z
KINGLET	K IH NG L AH T
KINGLET'S	K IH NG L AH T S
KINK	K IH NG K
KNEADS	N IY D Z
KNOTHOLE	N AA T HH OW L
KOOKABURRA	K UH K AH B AH R AH
KOWHAI	K OW HH EY
LABOURERS	L EY B ER ER Z
LABRADOR'S	L AE B R AH D AO R Z
LACECAP	L EY S K AE P
LACING	L EY S IH NG
LAKE'SAFE	L AE K AH S EY F
LAKEWIND	L EY K W IH N D
LAMBENT	L AE M AH N T
LAMENTATION	L AE M AH N T EY SH AH N
LAMPLIT	L AE M P L IH T
LANTERN'S	L AE N T ER N Z
LAPWINGS	L AE P W IH NG Z
LARK'S	L AA R K S
LARKSONG	L AA R K S AO NG
LATHERED	L AE DH ER D
LAUNDRY'S	L AO N D R IY Z
LAWN'S	L AO N Z
LEAFPILE	L IY F P AY L
LILACSCENT	L AY L AE K S EH N T
LIMPET	L IH M P AH T
LIQUIDAMBER	L IH K W AH D AE M B ER
LOBELIA	L AH B IY L Y AH
LONGNECK	L AO NG N EH K
LOOSEKNIT	L UW S N IH T
LOPING	L OW P IH NG
LORIKEET	L AO R AH K IY T
LOVEBIRDS	L AH V B ER D Z
MACHU	M AE CH UW
MACROCARPA	M AE K R AH K AA R P AH
MADRONA	M AE D R AH N AH
MALLETS	M AE L EH T S
MANGOS	M AE N G OW Z
MANIKIN	M AE N IH K AH N
MANZANAR	M AE N Z AH N AH R
MARGINALIA	M AA R JH AH N EY L Y AH
MARMOT	M AA R M AH T
MAYA'S	M AY AH Z
MAYFLIES	M EY F L AY Z
MAYFLY	M EY F L AY
MEADOWLARK'S	M EH D OW L AA R K S
MEADOWLARKS	M EH D OW L AA R K S
MEDAL'S	M EH D AH L Z
MEDEVAC	M EH D AH V AH K
MEETINGHOUSE	M IY T IH NG HH AW S
MEM	M EH M
MENDS	M EH N D Z
MENFOLK	M EH N F OW K
MENSES	M EH N Z IH Z
MEOWING	M IY OW AH NG
MERGANSER	M AH R G AE N Z AH R
MIDNIGHTS	M IH D N AY T S
MIDRIFFS	M IH D R IH F S
MIDSTRIDE	M IH D S T R AY D
MIDSUMMER'S	M IH D S AH M ER Z
MILKMOON	M IH L K M UW N
MILLPOND	M IH L P AA N D
MIME'S	M AY M Z
MINESHAFT	M AY N SH AE F T
MISCARRIED	M IH S K AE R IY D
MISTRAL'S	M IH S T R AH L Z
MOCKINGBIRD'S	M AA K IH NG B ER D Z
MODIGLIANI'S	M OW D IH G L IY AA N IY Z
MOLDERING	M OW L D ER IH NG
MOLE'S	M OW L Z
MONGREL	M AA N G R AH L
MOONBOW	M UW N B AW
MOONFLOWER	M UW N F L AW ER
MOONFLOWERS	M UW N F L AW ER Z
MOONGLOW	M UW N G L OW
MOONSHADOW	M UW N SH AE D OW
MOORHEN'S	M UH R HH EH N Z
MOOSE'S	M UW S IX Z
MOTUARA	M AA T Y UW AH R AH
MOUSE'S	M AW S IX Z
MOUSETRAPS	M AW S T R AE P S
MOWER'S	M OW ER Z
MUDDIES	M AH D IY Z
MUDFLATS	M AH D F L AE T S
MUDHENS	M AH D HH EH N Z
MUGO	M Y UW G OW
MULLIONS	M AH L Y AH N Z
MUSHROOM'S	M AH SH R UW M Z
MUSKEG	M AH S AH G
MUSTANG'S	M AH S T AE NG Z
MYNAHS	M IH N AH Z
NAKEDNESS	N EY K AH D N AH S
NANA'S	N AE N AH Z
NASHI	N AE SH IY
NASTURTIUMS	N AE S T AH R T IY AH M Z
NEAP	N IY P
NEATENS	N IY T AH N Z
NEST'S	N EH S TS
NETTLEBED	N EH T AH L B EH D
NEWBORN'S	N UW B AO R N Z
NICKERING	N IH K ER IH NG
NICKING	N IH K IH NG
NIGHTBIRD	N AY T B ER D
NIGHTCRAWLERS	N AY T K R AO L ER Z
NIGHTINGALE'S	N AY T IH NG G EY L Z
NIRVANNA	N AH R V AE N AH
NONAGENARIAN'S	N AH N AE JH AH N AE R IY AH N Z
NOR'WESTER	N AO R W EH S T AH R
NOSEPRINTS	N OW Z P R IH N T S
NUBS	N AH B Z
NUMBERLESS	N AH M B ER L AH S
NUTHATCH	N AH T HH AE CH
NUTHATCH'S	N AH T HH AE CH IH Z
OCOTILLO	AA K AH T IH L OW
OCOTILLO'S	AA K AH T IH L AH Z
OJIBWE	AA JH AH B W
ONCOLOGIST'S	AA NG K AA L AH JH IH S TS
ONLYS	AO N L IY Z
OOM	UW M
ORCHID'S	AO R K AH D Z
ORIENTING	OW R IY EH N T IH NG
OSPREY'S	AO S P R IY Z
OSPREYS	AA S P R EY Z
OTHERWORLD	AH DH ER W ER L D
OUR'SAILS	AW ER Z EY L Z
OUTCROP	AW T K R AA P
OUZEL	AW Z AH L
OVENBIRD	AH V AH N B ER D
OYSTERCATCHER	OY S T ER K AE CH ER
PACKRAT	P AE K R AE T
PAEKAKARIKI	P IY K AH K AE R AH K IY
PAILFULL	P EY L F UH L
PALLBEARERS	P AO L B AE ER ER Z
PALOVERDE	P AE L AH V AH R D
PANSY'S	P AE N Z IY Z
PAPERCLIP	P EY P ER K L IH P
PAPERWHITES	P EY P ER W AY T S
PARACHUTISTS	P AE R AH SH UW T IH S T S
PARAKEET'S	P EH R AH K IY TS
PARAPLEGIC'S	P EH R AH P L EH G IH K S
PARASOL	P AE R AH S AO L
PARASOLS	P AE R AH S AO L Z
PARROTGREEN	P AE R AH T G R IY N
PARSNIPS	P AA R S N IH P S
PARTINGS	P AA R T IH NG Z
PARTWAY	P AA R T W EY
PASSIONFLOWER	P AE SH AH N F L AW ER
PEACH'S	P IY CH IX Z
PEACOCK'S	P IY K AA K S
PEBBLED	P EH B AH L D
PECKED	P EH K T
PECKS	P EH K S
PECS	P EH K S
PEELINGS	P IY L IH NG Z
PEEPAL	P IY P AH L
PEEPER	P IY P ER
PEEPERS	P IY P ER Z
PENSIONED	P EH N CH AH N D
PERCALE	P AH R K EY L
PEREGRINE'S	P EH R AH G R IY N Z
PERFECTS	P ER F AH K T S
PERSIMMONS	P ER S IH M AH N Z
PERSISTANT	P ER S IH S T AH N T
PESTO	P EH S T OW
PEWIT	P Y UW AH T
PFFFT	P IY EH F EH F EH F T
PHLOX	F L AA K S
PIANOBLACK	P IY AE N OW B L AE K
PICKAXE	P IH K AE K S
PICKER'S	P IH K ER Z
PICKERELWEED	P IH K AH R EH L W IY D
PICKUP'S	P IH K AH P S
PIER'S	P IH R Z
PIGTAIL	P IH G T EY L
PIGTAILS	P IH G T EY L Z
PIKA	P IH K AH
PILEATED'S	P AY L EY T IH D Z
PINCHES	P IH N CH IH Z
PINECONE	P AY N K OW N
PINWHEEL	P IH N W IY L
PINWHEELS	P IH N W IY L Z
PLAYMATE'S	P L EY M EY TS
PLOPS	P L AA P S
PLOWBOY	P L AW B OY
POCKETKNIFE	P AA K AH T N AY F
POKEBERRY	P OW K B EH R IY
PONGA	P AA N G AH
PONYTAILS	P OW N IY T EY L Z
POPLAR'S	P AA P L ER Z
POSSUM'S	P AA S AH M Z
POTTING	P AA T IH NG
POUNCES	P AW N S AH Z
PROJECTOR'S	P R AA JH EH K T ER Z
PROWLS	P R AW L Z
PTARMIGAN	T AA R M AH G AH N
PUFFBALLS	P AH F B AO L Z
PULSATE	P AH L S AH T
PUPPY'S	P AH P IY Z
PUSSYWILLOW	P UH S IY W IH L OW
PUSSYWILLOWS	P UH S IY W IH L OW Z
QUIVERS	K W IH V ER Z
R'SUM	R S AH M
RABBIT'S	R AE B AH TS
RACCOON'S	R AE K UW N Z
RAGMAN'S	R AE G M AE N Z
RAILBED	R EY L B EH D
RAINBOW'S	R EY N B OW Z
RAM'S	R AE M Z
RAMBUTAN	R AE M B Y UW T AH N
RANGITOTO'S	R AE N JH IH T AH T AH Z
REBLOOMING	R IY B L UW M IH NG
REDDENED	R EH D AH N D
REDDENING	R EH D AH N IH NG
REDDENS	R EH D AH N Z
REDGUM	R EH D G AH M
REDPOLL'S	R EH D P OW L Z
REDTAIL	R EH D T EY L
REDWING	R EH D W IH NG
REDWINGS	R EH D W IH NG Z
RENGA	R IH N G AA
REPELLANT	R IH P EH L AH N T
REPLY'S	R IH P L AY Z
RESIFTED	R IY S IH F T IH D
RESUM	R IY S AH M
RETCHES	R EH CH IH Z
RETINAS	R EH T AH N AH Z
RETOLD	R IY T OW L D
RETRIEVER'S	R IY T R IY V ER Z
REWORKS	R IY W ER K S
RIBBONING	R IH B AH N IH NG
RICING	R AY S IH NG
RIFFLES	R IH F AH L Z
RIFTED	R IH F T IH D
RILKE	R IH K
RIMU	R IH M UW
RINGER'S	R IH NG ER Z
RINGTONE	R IH NG T OW N
RINSED	R IH N S T
RIVERSTONE	R IH V ER S T OW N
ROCKINGHORSE	R AA K IH NG HH AO R S
ROLLIES	R OW L IY Z
ROOF'S	R UW F S
ROOK'S	R UH K S
ROOSTER'S	R UW S T ER Z
ROOTMASS	R UW T M AE S
ROSEHIPS	R OW Z HH IH P S
ROTHKO'S	R AA TH AH Z
ROTOTILLER'S	R OW T AH T IH L ER Z
ROUNDNESS	R AW N D N AH S
RUFFED	R AH F T
RUFOUS	R UW F AH S
RUGOSA	R UW G AH S AH
RUMPS	R AH M P S
SACAGAWEA'S	S AH K AE G AH IY Z
SACR	S AE K R
SADDLEBACK	S AE D AH L B AE K
SALT'S	S AO L TS
SANDCASTLE	S AE N D K AE S AH L
SANDCASTLES	S AE N D K AE S AH L Z
SANDCRAB	S AE N D K R AE B
SANDFLIES	S AE N D F L AY Z
SANDFLY	S AE N D F L AY
SANDPIPERS	S AE N D P AY P ER Z
SANTOKA	S AE N T AH K AH
SAPLING'S	S AE P L IH NG Z
SATURATES	S AE CH ER AH T S
SAVOUR	S AE V AH R
SAWHORSE	S AO HH AO R S
SCHOOLGIRL'S	S K UW L G ER L Z
SCIMITAR	S IH M AH T ER
SCOTERS	S K AA T ER Z
SCRATCHER	S K R AE CH ER
SCRUBWOODS	S K R AH B W UH D Z
SCRUM	S K R AH M
SCYTHING	S IH DH AH NG
SEABIRD	S IY B ER D
SEABIRDS	S IY B ER D Z
SEAFROTH	S IY F R AO TH
SEAWALL	S IY W AO L
SEDGES	S EH JH AH Z
SEEDTHE	S IY D
SEERSUCKER	S IH ER S AH K ER
SEMI'S	S EH M IY Z
SERGEANT'S	S AA R JH AH N TS
SEUSS'S	S UW S IX Z
SHACK'S	SH AE K S
SHADOW'S	SH AE D OW Z
SHAG'S	SH AE G Z
SHAKUHACHI	SH AH K AH HH AH CH IY
SHAMAN'S	SH EY M AH N Z
SHARPENER	SH AA R P AH N ER
SHED'S	SH EH D Z
SHEEPBELLS	SH IY P B EH L Z
SHINS	SH IH N Z
SHOAL	SH OW L
SHOESHINER'S	SH UW SH AY N ER Z
SHOOS	SH UW Z
SHOPAHOLICS	SH AA P AH HH OW L IH K S
SHOVEL'S	SH AH V AH L Z
SHOVELLING	SH AH V AH L IH NG
SHRIKE	SH R AY K
SHRIKE'S	SH R AY K AH Z
SHRIMPING	SH R IH M P IH NG
SHROVE	SH R OW V
SHUSH	SH AH SH
SHUSHES	SH AH SH AH Z
SIDEBOARD	S AY D B OW R D
SIDELONG	S AY D L AO NG
SIDESLIPS	S AY D S L IH P S
SILAGE	S AY L AH JH
SILO'S	S AY L OW Z
SILTED	S IH L T AH D
SILVERBERRY	S IH L V ER B EH R IY
SILVERED	S IH L V ER D
SILVERFISH	S IH L V ER F IH SH
SINEWS	S IH N Y UW Z
SINKFUL	S IH NG K F AH L
SINNER'S	S IH N ER Z
SISKINS	S IY Z K IH N Z
SKIFF'S	S K IH F S
SKIMS	S K IH M Z
SKINK	S K IH NG K
SKINNING	S K IH N IH NG
SKINNYDIPPING	S K IH N IY D IH P IH NG
SKITTERING	S K IH T ER IH NG
SKITTERS	S K IH T ER Z
SKUNK'S	S K AH NG K S
SKYFUL	S K AY F AH L
SLAUGHTERYARD	S L AO T ER Y AA R D
SLEETING	S L IY T IH NG
SLICKNESS	S L IH K N AH S
SLIDESHOW	S L AY D SH OW
SLIMED	S L AY M D
SLINK	S L IH NG K
SLIPSTREAM	S L IH P S T R IY M
SLOSHES	S L AA SH IH Z
SLUG'S	S L AH G Z
SMOKEHOUSE	S M OW K HH AW S
SMOOTHES	S M UW DH Z
SMOULDER	S M OW L D AH R
SNAG'S	S N AE G Z
SNAKESKIN	S N EY K S K IH N
SNAKESKIN'S	S N EY K S K IH N Z
SNAPPER'S	S N AE P ER Z
SNOWBANK'S	S N OW B AE NG K S
SNOWCAPS	S N OW K AE P S
SNOWDUST	S N OW D AH S T
SNOWFIELD	S N OW F IY L D
SNOWLIGHT	S N OW L AY T
SNOWLIT	S N OW L IH T
SNOWMAN'S	S N OW M AE N Z
SOAPSUDS	S OW P S AH D Z
SOBA	S OW B AH
SONGBIRD'S	S AO NG B ER D Z
SONGWRITER'S	S AO NG R AY T ER Z
SOUNDLESSLY	S AW N D L AH S L IY
SPADEFULS	S P EY D F AH L Z
SPARKLER	S P AA R K AH L ER
SPARROWHAWK	S P AE R OW HH AO K
SPARSH	S P AA R SH
SPEARMINT	S P IH ER M IH N T
SPHAGNUM	S F AE G N AH M
SPHINXED	S F IH NG K S T
SPIDERLINGS	S P AY D ER L IH NG Z
SPINDLES	S P IH N D AH L Z
SPINDLY	S P IH N D AH L IY
SPITTLEBUGS	S P IH T AH L B AH G Z
SPRIG	S P R IH G
SPRINKLER'S	S P R IH NG K L ER Z
SPRITZES	S P R IH T S AH Z
SQUELCHES	S K W EH L CH IH Z
SQUIRREL'S	S K W ER AH L Z
SQUIRRELWAYS	S K W ER AH L W EY Z
STALACTITES	S T AE L AH K T AY T S
STALAGMITES	S T AA L AA G M AY T S
STAMEN	S T EY M AH N
STAMENS	S T EY M AH N Z
STAMMERS	S T AE M ER Z
STARGAZING	S T AA R G EY Z IH NG
STARLINGS	S T AA R L IH NG Z
STARSHINE	S T AA R SH AY N
STEADIES	S T EH D IY Z
STEELTOWN	S T IY L T AW N
STEEPS	S T IY P S
STEPPINGSTONES	S T EH P IH NG S T OW N Z
STILLBORN'S	S T IH L B AO R N Z
STIPPLE	S T IH P AH L
STIPPLED	S T IH P AH L D
STORK'S	S T AO R K S
STORKS	S T AO R K S
STORMLIGHT	S T AO R M L AY T
STORYTELLER'S	S T AO R IY T EH L ER Z
STOVEPIPE	S T OW V P AY P
STRAGGLES	S T R AE G AH L Z
STRAWMAN	S T R AO M AE N
STRIDERS	S T R AY D ER Z
STUMP'S	S T AH M P S
SUCKLES	S AH K AH L Z
SUET	S UW AH T
SUGARBOWL	SH UH G ER B OW L
SUMI	S UW M IY
SUNBEAMS	S AH N B IY M Z
SUNBURST	S AH N B ER S T
SUNCATCHER	S AH N K AE CH ER
SUNCATCHERS	S AH N K AE CH ER Z
SUNDECK	S AH N D EH K
SUNDIAL'S	S AH N D AY L Z
SUNDOG	S AH N D AO G
SUNGLARE	S AH N G L EH R
SUNNIEST	S AH N IY AH S T
SUNRAYS	S AH N R EY Z
SUNROLLING	S AH N R OW L IH NG
SUNSTREAMS	S AH N S T R IY M Z
SUPERMOON	S UW P ER M UW N
SUPPERTIME	S AH P ER T AY M
SURFCASTER'S	S ER F K AE S T ER Z
SURFER'S	S ER F ER Z
SUSANS	S UW Z AH N Z
SUSURRATION	S UW S AH R EY SH AH N
SWAINSON'S	S W EY N S AH N Z
SWALLOWTAIL	S W AA L OW T EY L
SWATHS	S W AA TH S
SWEETBOX	S W IY T B AA K S
SWEETFISH	S W IY T F IH SH
SWEETPEAS	S W IY T P IY Z
SWERVES	S W ER V Z
SWISHING	S W IH SH IH NG
SWITCHBACK	S W IH CH B AE K
SWORD'S	S AO R D Z
SYCAMORE'S	S IH K AH M AO R Z
SYNCOPATES	S IH NG K AH P EY T S
TAILLESS	T EY L AH S
TAMARACK	T AE M AH R AH K
TAMARACK'S	T AE M AH R AH K S
TANAGER	T AE N IH JH ER
TANGY	T AE NG IY
TARANTULA'S	T AH R AE N CH UW L AH Z
TARWEED	T AA R W IY D
TASSELS	T AE S AH L Z
TATSUKO'S	T AE T S UW K AH Z
TATTED	T AE T IH D
TATTING	T AE T IH NG
TATTOO'D	T AE T UW D
TEACUPS	T IY K AH P S
TEARDROPS	T IH ER D R AA P S
TEASHOP	T IY SH AA P
TENDRILS	T EH N D R AH L Z
TEPEES	T IY P IY Z
TETHERBALLS	T EH DH ER B AO L Z
THE'STINGRAY	DH AH Z T IH N G R EY
THISTLEDOWN	TH IH S T L AH D OW N
THRONGING	TH R AO NG IH NG
THRUSH'S	TH R AH SH IX Z
THUDDING	TH AH D IH NG
THUMBPRINT	TH AH M P R IH N T
THUNDERCLAP	TH AH N D ER K L AE P
THUNDERCLOUD	TH AH N D ER K L AW D
TIDEPOOL	T AY D P UW L
TINFUL	T IH N F AH L
TINK	T IH NG K
TINKLES	T IH NG K AH L Z
TINSMITH	T IH N S M IH TH
TINYHISS	T AY N IY HH IH S
TIPTOES	T IH P T OW Z
TITMOUSE	T IH T M AW S
TNGRS	T IY EH N JH IY AA R S
TODDLER'S	T AA D L ER Z
TOLLUND	T AA L AH N D
TOMBO	T AA M B OW
TOMCAT'S	T AA M K AE TS
TOOLSHED	T UW L SH EH D
TOOTHACHE	T UW TH EY K
TOPMOST	T AA P M OW S T
TOURGUIDE	T UH R G AY D
TOWHEE'S	T OW HH IY Z
TOWPATH	T OW P AE TH
TOYSHOP	T OY SH AA P
TRACINGS	T R EY S IH NG Z
TRAIL'S	T R EY L Z
TRANSFIGURED	T R AE N S F IH G Y ER D
TRASHCAN	T R AE SH K AE N
TRAWLER'S	T R AO L ER Z
TREECUTTER	T R IY K AH T ER
TREEFROGS	T R IY F R AA G Z
TREMBLES	T R EH M B AH L Z
TREMOLO	T R EH M AH L OW
TRICYCLES	T R IH S AH K AH L Z
TRISTESSE	T R IH S T AH S
TRUNK'S	T R AH NG K S
TUATARA	T Y UW AE T AH R AH
TUI	T UW
TUMBLEWEED	T AH M B AH L W IY D
TUMBLEWEEDS	T AH M B AH L W IY D Z
TURNROW	T ER N R OW
TUSSOCKS	T AH S AH K S
TWIG'S	T W IH G Z
TWILIT	T W IH L AH T
TXTG	T IY EH K S T IY G
ULU	Y UW L UW
UMP	AH M P
UNBLESSED	AH N B L EH S T
UNBRAID	AH N B R EY D
UNCOILS	AH N K OY L Z
UNCURLING	AH N K ER L IH NG
UNDERSIDES	AH N D ER S AY D Z
UNDERTAKERS	AH N D ER T EY K ER Z
UNEARTHS	AH N ER TH S
UNFADING	AH N F EY D IH NG
UNFURLS	AH N F ER L Z
UNILINGUAL	Y UW N IH L IH NG G W AH L
UNLACED	AH N L EY S T
UNLEARNING	AH N L ER N IH NG
UNLIT	AH N L IH T
UNMAPPED	AH N M AE P T
UNPAIRED	AH N P EH R D
UNPEELED	AH N P IY L D
UNPINNED	AH N P IH N D
UNPLEATS	AH N P L IY T S
UNPRUNED	AH N P R UW N D
UNSEALS	AH N S IY L Z
UNSEASONABLE	AH N S IY Z AH N AH B AH L
UNSEASONAL	AH N S IY Z AH N AH L
UNSHARED	AH N SH EH R D
UNTANGLES	AH N T AE NG G AH L Z
UNTETHERED	AH N T EH DH ER D
UNWINDS	AH N W IH N D Z
UPCURLS	AH P K ER L Z
UPTURNED	AH P T ER N D
UPWIND	AH P W IH N D
VACATION'S	V EY K EY SH AH N Z
VEDIC	V IY D AH K
VEINED	V EY N D
VENTRILOQUIST	V EH N T R AH L AA K W AH S T
VIBRANCE	V AY B R AH N S
VIREO'S	V IH R IY AH Z
VJ	V IY JH
WADDLES	W AA D AH L Z
WAGTAIL'S	W AE G T EY L Z
WAITANGI	W EY T AE N JH IY
WALLAH	W AA L AH
WALPURGISNACHT	W AA L P AH R JH IH Z N AH CH T
WARBLER'S	W AO R B L ER Z
WASHBASINS	W AA SH B EY S AH N Z
WASHROOMS	W AA SH R UW M Z
WASN	W AA Z N
WATERCOLORIST	W AO T ER K AH L ER IH S T
WATERDROP	W AO T ER D R AA P
WATERDROPS	W AO T ER D R AA P S
WATERHOLE	W AO T ER HH OW L
WATERLILIES	W AO T ER L IY L IY Z
WATERLINE	W AO T ER L AY N
WATERPROOFS	W AO T ER P R UW F S
WATERSTRIDER	W AO T ER S T R AY D ER
WATERSTRIDER'S	W AO T ER S T R AY D ER Z
WEATHERVANE	W IY TH AH R V EY N
WEFT	W EH F T
WETS	W EH T S
WHAPPING	W AA P AH NG
WHATCHAMACALLITS	W AA CH AH M AH K AE L AH T S
WHEATFIELDS	W IY T F IY L D Z
WHEELCHAIR'S	W IY L CH EH R Z
WHELK	W EH K
WHELK'S	W EH L K S
WHETS	W EH T S
WHINNY	W IH N IY
WHIPPOORWILL	W IH P UH R W IH L
WHIRLIGIG	W AH R L AH JH AH G
WHIRR	W AH R
WHITEBAIT	W AY T B EY T
WHITECAPS	W AY T K AE P S
WHITETHROAT'S	W AY T TH R OW T S
WHITTLES	W IH T AH L Z
WICK'S	W IH K S
WIGEON	W IH JH AH N
WILLOW'S	W IH L OW Z
WILLOWTIP	W IH L OW T IH P
WIMPLE	W IH M P AH L
WINDBLOWN	W IH N D B L OW N
WINDOWSILL	W IH N D OW S IH L
WINDROWS	W IH N D R OW Z
WINDSOCK	W IH N D S AA K
WINGBEATS	W IH NG B IY T S
WINGTIP	W IH NG T IH P
WINTERING	W IH N T ER IH NG
WINTERY	W IH N T ER IY
WIPEOUTS	W AY P AW T S
WIPER'S	W AY P ER Z
WISHBONES	W IH SH B OW N Z
WITCHDOCTOR'S	W IH CH D AA K T ER Z
WOBBLES	W AA B AH L Z
WOODBURNING	W UH D B ER N IH NG
WOODCARVER'S	W UH D K AA R V ER Z
WOODCHUCK'S	W UH D CH AH K S
WOODCUT	W UH D K AH T
WOODSHOP	W UH D SH AA P
WOODSTOVE'S	W UH D S T OW V Z
WORDLESSNESS	W ER D L AH S N AH S
WOULDN	W OW L D N
WREN'S	R EH N Z
WRENSONG	R EH N S AH NG
WRINGS	R IH NG Z
WRITHES	R AY DH Z
YABBIES	Y AE B AY Z
YAHRZEIT	Y AE R Z IY T
YEARLESS	Y IH ER L AH S
YELLOWJACKETS	Y EH L OW JH AE K AH T S
YETI'S	Y EH T IY Z
YUKATTA	Y UW K AE T AH
ZAPPER	Z AE P AH R
ZINGS	Z IH NG Z
BK	B IY K
BUFFLEHEAD	B AH F L AH HH IY D
CHATTERS	CH AE T ER Z
EARTHWORKS	ER TH W ER K S
ECCLESIASTES	EH K L IY S IY AH S T S
GNOMON	N OW M AH N
LUNCHBOX	L AH N CH B AA K S
LUNCHBREAK	L AH N CH B R EY K
MATTED	M AE T IH D
PLUNKS	P L AH NG K S
REGROWTH	R IY G R OW TH
SCUTTLES	S K AH T AH L Z
WHIR	W ER